111111111
100000001
100E1C111
111001001
100001111
111111111