111111111
100000001
100E1P111
111001001
1C0001111
111111111