111111111
100000001
100CCP011
111000001
11E001111
111111111