1111111
100E101
10C0101
11001P1
1111111