1111111
1C1E1P1
1010101
1000001
1000001
1111111