111111111
1E0110001
10011CC01
100111101
1P0000001
111111111