111111111111111111111111111111111111
10P000000001110000000001110011110001
10000000000000C001000000100000000011
10000000C000000001111010101100011011
10001100000000000C100000111110000C01
10000000000000C001110001100000111101
10000000C000111100011101101100111001
100000000011111001C0000C001000C00001
100C00000001000001000111110001100001
11111111000000110111000C000011001101
101000000001110001001000111001111001
10000000000000C000001111100000001111
10000000C000000001111000101010101011
100011000000000001C0010000C011100001
10000000000000C001000111110000000001
10000000C0000000011000000C0000000001
100000000011111000001111100111000001
100C0000000E000001000000000000C00001
111111111111111111111111111111111111