111111
1E1C11
100001
101P11
111111